11111111111111111111111
100P00X00000011000E1111
1C0P0001C10000111011111
11111111111000011001111
11111111111110000000111
11111111111111111111111