11111111111111111111111
100P00000000011000E1111
10000001010000111011111
11111111111000011001111
11111111111110000000111
11111111111111111111111