11111111111111111111111
100P00000000011000E1111
1C000001C10000111011111
11111111111000011001111
1111111111111000000E111
11111111111111111111111