11111111111111111111111
100P00X00000011000E1111
1C000001C10000111011111
11111111111000011001111
01111111111110000000111
11111111111111111111111