11111111111111111111111
100P00000000011000E1111
1CO00001C10000111011111
11111111111M00011001111
11111111111110000000111
11111111111111111111111